{
  "id": "level_008",
  "name": "Crossroads",
  "difficulty": 10,
  "size": { "width": 13, "height": 13 },
  "start": { "x": 6, "z": 1, "orientation": "standing" },
  "goal": { "x": 6, "z": 11 },
  "tiles": [
    [0, 0, 0, 0, 0, 0, 0, 0, 0, 0, 0, 0, 0],
    [0, 0, 0, 0, 0, 0, 1, 0, 0, 0, 0, 0, 0],
    [0, 0, 0, 0, 0, 0, 1, 0, 0, 0, 0, 0, 0],
    [0, 1, 1, 1, 1, 1, 1, 1, 1, 1, 1, 1, 0],
    [0, 1, 0, 0, 0, 0, 3, 0, 0, 0, 0, 1, 0],
    [0, 1, 0, 1, 1, 1, 1, 1, 1, 1, 0, 1, 0],
    [0, 1, 0, 1, 0, 0, 3, 0, 0, 1, 0, 1, 0],
    [0, 1, 0, 1, 1, 1, 1, 1, 1, 1, 0, 1, 0],
    [0, 1, 0, 0, 0, 0, 3, 0, 0, 0, 0, 1, 0],
    [0, 1, 1, 1, 1, 1, 1, 1, 1, 1, 1, 1, 0],
    [0, 0, 0, 0, 0, 0, 1, 0, 0, 0, 0, 0, 0],
    [0, 0, 0, 0, 0, 0, 9, 0, 0, 0, 0, 0, 0],
    [0, 0, 0, 0, 0, 0, 0, 0, 0, 0, 0, 0, 0]
  ],
  "solution": ["down", "right", "right", "right", "right", "right", "down", "down", "down", "left", "left", "left", "down", "down", "down", "left", "left", "left", "up", "up", "up", "right", "right", "right", "down", "down"],
  "minMoves": 26
}
