{
  "id": "level_004",
  "name": "Choose Wisely",
  "difficulty": 8,
  "size": { "width": 10, "height": 10 },
  "start": { "x": 1, "z": 1, "orientation": "standing" },
  "goal": { "x": 7, "z": 7 },
  "tiles": [
    [0, 0, 0, 0, 0, 0, 0, 0, 0, 0],
    [0, 1, 1, 1, 1, 0, 0, 0, 0, 0],
    [0, 0, 0, 0, 1, 0, 0, 0, 0, 0],
    [0, 0, 0, 0, 1, 0, 0, 0, 0, 0],
    [0, 0, 0, 0, 1, 1, 1, 1, 0, 0],
    [0, 0, 0, 0, 3, 0, 0, 1, 0, 0],
    [0, 0, 0, 0, 3, 0, 0, 1, 0, 0],
    [0, 0, 0, 0, 3, 1, 1, 9, 0, 0],
    [0, 0, 0, 0, 0, 0, 0, 0, 0, 0],
    [0, 0, 0, 0, 0, 0, 0, 0, 0, 0]
  ],
  "solution": ["right", "right", "down", "down", "right", "right", "down", "down", "down"],
  "minMoves": 9
}
