{
  "id": "level_032",
  "name": "Desert Storm",
  "difficulty": 8,
  "size": { "width": 14, "height": 7 },
  "start": { "x": 1, "z": 3, "orientation": "standing" },
  "goal": { "x": 10, "z": 3 },
  "tiles": [
    [0, 0, 0, 0, 0, 0, 0, 0, 0, 0, 0, 0, 0, 0],
    [0, 1, 3, 3, 3, 3, 3, 3, 3, 3, 1, 0, 0, 0],
    [0, 1, 0, 0, 0, 0, 0, 0, 0, 0, 1, 0, 0, 0],
    [0, 1, 1, 1, 1, 1, 1, 1, 1, 1, 9, 0, 0, 0],
    [0, 1, 0, 0, 0, 0, 0, 0, 0, 0, 1, 0, 0, 0],
    [0, 1, 3, 3, 3, 3, 3, 3, 3, 3, 1, 0, 0, 0],
    [0, 0, 0, 0, 0, 0, 0, 0, 0, 0, 0, 0, 0, 0]
  ],
  "solution": ["right", "right", "right", "right", "right"],
  "minMoves": 5
}
