{
  "id": "level_008",
  "name": "Fragile Bridge",
  "difficulty": 8,
  "size": { "width": 14, "height": 8 },
  "start": { "x": 1, "z": 4, "orientation": "standing" },
  "goal": { "x": 10, "z": 4 },
  "tiles": [
    [0, 0, 0, 0, 0, 0, 0, 0, 0, 0, 0, 0, 0, 0],
    [0, 1, 1, 1, 2, 2, 2, 2, 1, 1, 1, 0, 0, 0],
    [0, 1, 0, 0, 0, 0, 0, 0, 0, 0, 1, 0, 0, 0],
    [0, 1, 0, 0, 0, 0, 0, 0, 0, 0, 1, 0, 0, 0],
    [0, 1, 1, 1, 1, 1, 1, 1, 1, 1, 9, 0, 0, 0],
    [0, 1, 0, 0, 0, 0, 0, 0, 0, 0, 1, 0, 0, 0],
    [0, 1, 1, 1, 2, 2, 2, 2, 1, 1, 1, 0, 0, 0],
    [0, 0, 0, 0, 0, 0, 0, 0, 0, 0, 0, 0, 0, 0]
  ],
  "solution": ["right", "right", "right", "right", "right"],
  "minMoves": 5
}
