{
  "id": "level_023",
  "name": "Double Back",
  "difficulty": 6,
  "size": { "width": 12, "height": 12 },
  "start": { "x": 1, "z": 1, "orientation": "standing" },
  "goal": { "x": 1, "z": 10 },
  "tiles": [
    [0, 0, 0, 0, 0, 0, 0, 0, 0, 0, 0, 0],
    [0, 1, 1, 1, 1, 1, 1, 1, 0, 0, 0, 0],
    [0, 0, 0, 0, 0, 0, 0, 1, 0, 0, 0, 0],
    [0, 0, 0, 0, 0, 0, 0, 1, 0, 0, 0, 0],
    [0, 0, 0, 0, 1, 1, 1, 1, 0, 0, 0, 0],
    [0, 0, 0, 0, 1, 0, 0, 0, 0, 0, 0, 0],
    [0, 0, 0, 0, 1, 0, 0, 0, 0, 0, 0, 0],
    [0, 0, 0, 0, 1, 1, 1, 1, 0, 0, 0, 0],
    [0, 0, 0, 0, 0, 0, 0, 1, 0, 0, 0, 0],
    [0, 0, 0, 0, 0, 0, 0, 1, 0, 0, 0, 0],
    [0, 9, 1, 1, 1, 1, 1, 1, 0, 0, 0, 0],
    [0, 0, 0, 0, 0, 0, 0, 0, 0, 0, 0, 0]
  ],
  "solution": ["right", "right", "right", "down", "down", "left", "left", "down", "down", "right", "right", "down", "down", "left", "left", "left"],
  "minMoves": 16
}
