{
  "id": "level_010",
  "name": "The Gauntlet",
  "difficulty": 10,
  "size": { "width": 15, "height": 13 },
  "start": { "x": 1, "z": 6, "orientation": "standing" },
  "goal": { "x": 13, "z": 6 },
  "tiles": [
    [0, 0, 0, 0, 0, 0, 0, 0, 0, 0, 0, 0, 0, 0, 0],
    [0, 1, 1, 1, 3, 1, 1, 1, 1, 1, 3, 1, 1, 1, 0],
    [0, 1, 0, 0, 0, 0, 0, 1, 0, 0, 0, 0, 0, 1, 0],
    [0, 1, 0, 1, 1, 1, 0, 1, 0, 1, 1, 1, 0, 1, 0],
    [0, 1, 0, 1, 0, 1, 0, 2, 0, 1, 0, 1, 0, 1, 0],
    [0, 1, 0, 1, 0, 1, 1, 1, 1, 1, 0, 1, 0, 1, 0],
    [0, 1, 1, 1, 0, 0, 0, 2, 0, 0, 0, 1, 1, 9, 0],
    [0, 1, 0, 1, 0, 1, 1, 1, 1, 1, 0, 1, 0, 1, 0],
    [0, 1, 0, 1, 0, 1, 0, 2, 0, 1, 0, 1, 0, 1, 0],
    [0, 1, 0, 1, 1, 1, 0, 1, 0, 1, 1, 1, 0, 1, 0],
    [0, 1, 0, 0, 0, 0, 0, 1, 0, 0, 0, 0, 0, 1, 0],
    [0, 1, 1, 1, 3, 1, 1, 1, 1, 1, 3, 1, 1, 1, 0],
    [0, 0, 0, 0, 0, 0, 0, 0, 0, 0, 0, 0, 0, 0, 0]
  ],
  "solution": ["up", "up", "up", "up", "up", "right", "right", "down", "down", "right", "right", "up", "up", "right", "right", "down", "down", "right", "right", "up", "up", "right", "right", "down", "down", "down", "down", "down"],
  "minMoves": 28
}
