{
  "id": "level_035",
  "name": "Puzzle Box",
  "difficulty": 8,
  "size": { "width": 14, "height": 14 },
  "start": { "x": 4, "z": 4, "orientation": "standing" },
  "goal": { "x": 10, "z": 10 },
  "tiles": [
    [0, 0, 0, 0, 0, 0, 0, 0, 0, 0, 0, 0, 0, 0],
    [0, 1, 1, 1, 1, 1, 1, 1, 1, 1, 1, 0, 0, 0],
    [0, 1, 0, 0, 0, 0, 0, 0, 0, 0, 1, 0, 0, 0],
    [0, 1, 0, 0, 0, 0, 0, 0, 0, 0, 1, 0, 0, 0],
    [0, 1, 0, 0, 1, 1, 1, 1, 0, 0, 1, 0, 0, 0],
    [0, 1, 0, 0, 1, 0, 0, 1, 0, 0, 1, 0, 0, 0],
    [0, 1, 0, 0, 1, 0, 0, 1, 0, 0, 1, 0, 0, 0],
    [0, 1, 0, 0, 1, 1, 1, 1, 0, 0, 1, 0, 0, 0],
    [0, 1, 0, 0, 0, 0, 0, 0, 0, 0, 1, 0, 0, 0],
    [0, 1, 0, 0, 0, 0, 0, 0, 0, 0, 1, 0, 0, 0],
    [0, 1, 1, 1, 1, 1, 1, 1, 1, 1, 9, 0, 0, 0],
    [0, 0, 0, 0, 0, 0, 0, 0, 0, 0, 0, 0, 0, 0],
    [0, 0, 0, 0, 0, 0, 0, 0, 0, 0, 0, 0, 0, 0],
    [0, 0, 0, 0, 0, 0, 0, 0, 0, 0, 0, 0, 0, 0]
  ],
  "solution": ["up", "up", "up", "left", "left", "left", "down", "down", "down", "down", "down", "down", "down", "down", "down", "right", "right", "right", "right", "right", "right"],
  "minMoves": 21
}
