{
  "id": "level_019",
  "name": "Spiral Descent",
  "difficulty": 10,
  "size": { "width": 14, "height": 14 },
  "start": { "x": 1, "z": 1, "orientation": "standing" },
  "goal": { "x": 7, "z": 7 },
  "tiles": [
    [0, 0, 0, 0, 0, 0, 0, 0, 0, 0, 0, 0, 0, 0],
    [0, 1, 1, 1, 1, 1, 1, 1, 1, 1, 1, 1, 1, 0],
    [0, 0, 0, 0, 0, 0, 0, 0, 0, 0, 0, 0, 1, 0],
    [0, 0, 0, 0, 0, 0, 0, 0, 0, 0, 0, 0, 1, 0],
    [0, 1, 1, 1, 1, 1, 1, 1, 1, 1, 0, 0, 1, 0],
    [0, 1, 0, 0, 0, 0, 0, 0, 0, 1, 0, 0, 1, 0],
    [0, 1, 0, 0, 0, 0, 0, 0, 0, 1, 0, 0, 1, 0],
    [0, 1, 0, 0, 0, 0, 0, 9, 1, 1, 0, 0, 1, 0],
    [0, 1, 0, 0, 0, 0, 0, 1, 0, 0, 0, 0, 1, 0],
    [0, 1, 0, 0, 0, 0, 0, 1, 0, 0, 0, 0, 1, 0],
    [0, 1, 1, 1, 1, 1, 1, 1, 0, 0, 0, 0, 1, 0],
    [0, 0, 0, 0, 0, 0, 0, 0, 0, 0, 0, 0, 1, 0],
    [0, 0, 0, 0, 0, 0, 0, 0, 0, 0, 0, 0, 1, 0],
    [0, 0, 0, 0, 0, 0, 0, 0, 0, 0, 0, 0, 0, 0]
  ],
  "solution": ["right", "right", "right", "right", "right", "right", "down", "down", "down", "down", "down", "down", "left", "left", "left", "left", "left", "up", "up", "up", "right", "right", "right", "down", "down", "left"],
  "minMoves": 26
}
