{
  "id": "level_029",
  "name": "Precision",
  "difficulty": 7,
  "size": { "width": 12, "height": 12 },
  "start": { "x": 1, "z": 4, "orientation": "standing" },
  "goal": { "x": 10, "z": 4 },
  "tiles": [
    [0, 0, 0, 0, 0, 0, 0, 0, 0, 0, 0, 0],
    [0, 0, 0, 1, 1, 1, 1, 1, 1, 0, 0, 0],
    [0, 0, 0, 1, 0, 0, 0, 0, 1, 0, 0, 0],
    [0, 0, 0, 1, 0, 0, 0, 0, 1, 0, 0, 0],
    [0, 1, 1, 1, 0, 0, 0, 0, 1, 1, 9, 0],
    [0, 0, 0, 1, 0, 0, 0, 0, 1, 0, 0, 0],
    [0, 0, 0, 1, 0, 0, 0, 0, 1, 0, 0, 0],
    [0, 0, 0, 1, 1, 1, 1, 1, 1, 0, 0, 0],
    [0, 0, 0, 0, 0, 0, 0, 0, 0, 0, 0, 0],
    [0, 0, 0, 0, 0, 0, 0, 0, 0, 0, 0, 0],
    [0, 0, 0, 0, 0, 0, 0, 0, 0, 0, 0, 0],
    [0, 0, 0, 0, 0, 0, 0, 0, 0, 0, 0, 0]
  ],
  "solution": ["right", "up", "up", "up", "right", "right", "right", "down", "down", "down", "down", "down", "down", "left", "left", "left", "up", "up", "up", "right", "right", "right", "right"],
  "minMoves": 23
}
