{
  "id": "level_022",
  "name": "Thin Ice",
  "difficulty": 6,
  "size": { "width": 12, "height": 10 },
  "start": { "x": 1, "z": 4, "orientation": "standing" },
  "goal": { "x": 10, "z": 4 },
  "tiles": [
    [0, 0, 0, 0, 0, 0, 0, 0, 0, 0, 0, 0],
    [0, 1, 2, 2, 2, 2, 2, 2, 2, 2, 1, 0],
    [0, 1, 0, 0, 0, 0, 0, 0, 0, 0, 1, 0],
    [0, 1, 0, 0, 0, 0, 0, 0, 0, 0, 1, 0],
    [0, 1, 1, 1, 1, 1, 1, 1, 1, 1, 9, 0],
    [0, 1, 0, 0, 0, 0, 0, 0, 0, 0, 1, 0],
    [0, 1, 0, 0, 0, 0, 0, 0, 0, 0, 1, 0],
    [0, 1, 2, 2, 2, 2, 2, 2, 2, 2, 1, 0],
    [0, 0, 0, 0, 0, 0, 0, 0, 0, 0, 0, 0],
    [0, 0, 0, 0, 0, 0, 0, 0, 0, 0, 0, 0]
  ],
  "solution": ["right", "right", "right", "right", "right"],
  "minMoves": 5
}
