{
  "id": "level_045",
  "name": "Purgatory",
  "difficulty": 10,
  "size": { "width": 14, "height": 12 },
  "start": { "x": 1, "z": 4, "orientation": "standing" },
  "goal": { "x": 10, "z": 4 },
  "tiles": [
    [0, 0, 0, 0, 0, 0, 0, 0, 0, 0, 0, 0, 0, 0],
    [0, 0, 1, 2, 2, 2, 2, 2, 2, 1, 0, 0, 0, 0],
    [0, 0, 1, 0, 0, 0, 0, 0, 0, 1, 0, 0, 0, 0],
    [0, 0, 1, 0, 3, 3, 3, 3, 0, 1, 0, 0, 0, 0],
    [0, 1, 1, 0, 3, 1, 1, 3, 0, 1, 9, 0, 0, 0],
    [0, 0, 1, 0, 3, 3, 3, 3, 0, 1, 0, 0, 0, 0],
    [0, 0, 1, 0, 0, 0, 0, 0, 0, 1, 0, 0, 0, 0],
    [0, 0, 1, 2, 2, 2, 2, 2, 2, 1, 0, 0, 0, 0],
    [0, 0, 0, 0, 0, 0, 0, 0, 0, 0, 0, 0, 0, 0],
    [0, 0, 0, 0, 0, 0, 0, 0, 0, 0, 0, 0, 0, 0],
    [0, 0, 0, 0, 0, 0, 0, 0, 0, 0, 0, 0, 0, 0],
    [0, 0, 0, 0, 0, 0, 0, 0, 0, 0, 0, 0, 0, 0]
  ],
  "solution": ["right", "up", "up", "up", "right", "right", "right", "right", "down", "down", "down", "right"],
  "minMoves": 12
}
