{
  "id": "level_030",
  "name": "Labyrinth",
  "difficulty": 8,
  "size": { "width": 14, "height": 12 },
  "start": { "x": 1, "z": 1, "orientation": "standing" },
  "goal": { "x": 10, "z": 10 },
  "tiles": [
    [0, 0, 0, 0, 0, 0, 0, 0, 0, 0, 0, 0, 0, 0],
    [0, 1, 1, 1, 1, 1, 1, 1, 0, 0, 0, 0, 0, 0],
    [0, 0, 0, 0, 0, 0, 0, 1, 0, 0, 0, 0, 0, 0],
    [0, 0, 0, 0, 0, 0, 0, 1, 0, 0, 0, 0, 0, 0],
    [0, 0, 0, 0, 1, 1, 1, 1, 1, 1, 1, 0, 0, 0],
    [0, 0, 0, 0, 1, 0, 0, 0, 0, 0, 1, 0, 0, 0],
    [0, 0, 0, 0, 1, 0, 0, 0, 0, 0, 1, 0, 0, 0],
    [0, 0, 0, 0, 1, 1, 1, 1, 0, 0, 1, 0, 0, 0],
    [0, 0, 0, 0, 0, 0, 0, 1, 0, 0, 1, 0, 0, 0],
    [0, 0, 0, 0, 0, 0, 0, 1, 0, 0, 1, 0, 0, 0],
    [0, 0, 0, 0, 0, 0, 0, 1, 1, 1, 9, 0, 0, 0],
    [0, 0, 0, 0, 0, 0, 0, 0, 0, 0, 0, 0, 0, 0]
  ],
  "solution": ["right", "right", "right", "down", "down", "left", "left", "down", "down", "right", "right", "right", "down", "down", "down", "right", "right"],
  "minMoves": 17
}
