{
  "id": "level_009",
  "name": "Dead End Maze",
  "difficulty": 10,
  "size": { "width": 15, "height": 11 },
  "start": { "x": 1, "z": 5, "orientation": "standing" },
  "goal": { "x": 13, "z": 5 },
  "tiles": [
    [0, 0, 0, 0, 0, 0, 0, 0, 0, 0, 0, 0, 0, 0, 0],
    [0, 1, 1, 1, 1, 1, 0, 1, 0, 1, 1, 1, 1, 1, 0],
    [0, 1, 0, 0, 0, 1, 0, 1, 0, 1, 0, 0, 0, 1, 0],
    [0, 1, 0, 1, 1, 1, 1, 1, 1, 1, 1, 1, 0, 1, 0],
    [0, 1, 0, 1, 0, 0, 0, 3, 0, 0, 0, 1, 0, 1, 0],
    [0, 1, 1, 1, 0, 1, 1, 1, 1, 1, 0, 1, 1, 9, 0],
    [0, 1, 0, 1, 0, 0, 0, 3, 0, 0, 0, 1, 0, 1, 0],
    [0, 1, 0, 1, 1, 1, 1, 1, 1, 1, 1, 1, 0, 1, 0],
    [0, 1, 0, 0, 0, 1, 0, 1, 0, 1, 0, 0, 0, 1, 0],
    [0, 1, 1, 1, 1, 1, 0, 1, 0, 1, 1, 1, 1, 1, 0],
    [0, 0, 0, 0, 0, 0, 0, 0, 0, 0, 0, 0, 0, 0, 0]
  ],
  "solution": ["up", "up", "up", "up", "right", "right", "down", "down", "right", "right", "right", "right", "up", "up", "right", "right", "down", "down", "down", "down"],
  "minMoves": 20
}
