{
  "id": "level_003",
  "name": "Trap Maze",
  "difficulty": 8,
  "size": { "width": 11, "height": 11 },
  "start": { "x": 1, "z": 4, "orientation": "standing" },
  "goal": { "x": 7, "z": 7 },
  "tiles": [
    [0, 0, 0, 0, 0, 0, 0, 0, 0, 0, 0],
    [0, 1, 1, 1, 1, 1, 1, 1, 0, 0, 0],
    [0, 1, 0, 0, 0, 0, 0, 1, 0, 0, 0],
    [0, 1, 0, 0, 0, 0, 0, 1, 0, 0, 0],
    [0, 1, 1, 1, 2, 1, 1, 1, 0, 0, 0],
    [0, 1, 0, 0, 0, 0, 0, 1, 0, 0, 0],
    [0, 1, 0, 0, 0, 0, 0, 1, 0, 0, 0],
    [0, 1, 1, 1, 3, 1, 1, 9, 0, 0, 0],
    [0, 0, 0, 0, 0, 0, 0, 0, 0, 0, 0],
    [0, 0, 0, 0, 0, 0, 0, 0, 0, 0, 0],
    [0, 0, 0, 0, 0, 0, 0, 0, 0, 0, 0]
  ],
  "solution": ["up", "up", "up", "right", "right", "right", "down", "down", "down", "down", "down", "down"],
  "minMoves": 12
}
