{
  "id": "level_005",
  "name": "Sand Deception",
  "difficulty": 10,
  "size": { "width": 13, "height": 9 },
  "start": { "x": 1, "z": 4, "orientation": "standing" },
  "goal": { "x": 11, "z": 4 },
  "tiles": [
    [0, 0, 0, 0, 0, 0, 0, 0, 0, 0, 0, 0, 0],
    [0, 1, 1, 1, 1, 2, 1, 1, 2, 1, 1, 1, 0],
    [0, 1, 0, 0, 0, 0, 1, 0, 0, 0, 0, 1, 0],
    [0, 1, 0, 1, 1, 1, 1, 1, 1, 1, 0, 1, 0],
    [0, 1, 0, 1, 0, 0, 2, 0, 0, 1, 0, 9, 0],
    [0, 1, 0, 1, 1, 1, 1, 1, 1, 1, 0, 1, 0],
    [0, 1, 0, 0, 0, 0, 1, 0, 0, 0, 0, 1, 0],
    [0, 1, 1, 1, 1, 2, 1, 1, 2, 1, 1, 1, 0],
    [0, 0, 0, 0, 0, 0, 0, 0, 0, 0, 0, 0, 0]
  ],
  "solution": ["up", "up", "up", "right", "right", "down", "down", "right", "right", "up", "up", "right", "right", "down", "down", "down"],
  "minMoves": 16
}
