{
  "id": "level_007",
  "name": "Spiral Trap",
  "difficulty": 10,
  "size": { "width": 13, "height": 13 },
  "start": { "x": 1, "z": 1, "orientation": "standing" },
  "goal": { "x": 6, "z": 6 },
  "tiles": [
    [0, 0, 0, 0, 0, 0, 0, 0, 0, 0, 0, 0, 0],
    [0, 1, 1, 1, 1, 1, 1, 1, 1, 1, 1, 1, 0],
    [0, 0, 0, 0, 0, 0, 0, 0, 0, 0, 0, 1, 0],
    [0, 1, 1, 1, 1, 1, 1, 1, 1, 1, 0, 1, 0],
    [0, 1, 0, 0, 0, 0, 0, 0, 0, 1, 0, 1, 0],
    [0, 1, 0, 1, 1, 1, 1, 1, 0, 1, 0, 1, 0],
    [0, 1, 0, 1, 0, 0, 9, 1, 0, 1, 0, 1, 0],
    [0, 1, 0, 1, 0, 0, 0, 1, 0, 1, 0, 1, 0],
    [0, 1, 0, 1, 1, 1, 1, 1, 0, 1, 0, 1, 0],
    [0, 1, 0, 0, 0, 0, 0, 0, 0, 1, 0, 1, 0],
    [0, 1, 1, 1, 1, 1, 1, 1, 1, 1, 0, 1, 0],
    [0, 0, 0, 0, 0, 0, 0, 0, 0, 0, 0, 1, 0],
    [0, 0, 0, 0, 0, 0, 0, 0, 0, 0, 0, 0, 0]
  ],
  "solution": ["right", "right", "right", "right", "right", "down", "down", "down", "down", "down", "left", "left", "left", "left", "up", "up", "up", "up", "right", "right", "right", "down", "down", "left"],
  "minMoves": 24
}
