{
  "id": "level_006",
  "name": "One Way Out",
  "difficulty": 10,
  "size": { "width": 11, "height": 11 },
  "start": { "x": 5, "z": 5, "orientation": "standing" },
  "goal": { "x": 9, "z": 1 },
  "tiles": [
    [0, 0, 0, 0, 0, 0, 0, 0, 0, 0, 0],
    [0, 1, 3, 3, 3, 1, 3, 3, 3, 9, 0],
    [0, 1, 0, 0, 0, 1, 0, 0, 0, 1, 0],
    [0, 1, 0, 1, 1, 1, 1, 1, 0, 1, 0],
    [0, 1, 0, 1, 0, 0, 0, 1, 0, 1, 0],
    [0, 1, 1, 1, 0, 1, 0, 1, 1, 1, 0],
    [0, 1, 0, 1, 0, 0, 0, 1, 0, 1, 0],
    [0, 1, 0, 1, 1, 1, 1, 1, 0, 1, 0],
    [0, 1, 0, 0, 0, 1, 0, 0, 0, 1, 0],
    [0, 1, 3, 3, 3, 1, 3, 3, 3, 1, 0],
    [0, 0, 0, 0, 0, 0, 0, 0, 0, 0, 0]
  ],
  "solution": ["up", "up", "left", "left", "up", "up", "right", "right", "right", "right", "up", "up"],
  "minMoves": 12
}
